0, 1, 166, 66, 383, 65
1, 2, 383, 65, 484, 195
2, 3, 484, 195, 372, 235, 325, 241, 164, 224
0, 3, 166, 66, 164, 224
0, 2, 166, 66, 230, 111, 258, 135, 291, 151, 334, 165, 406, 178, 484, 195
2, 10, 484, 195, 633, 164, 659, 150, 676, 132, 707, 66
1, 10, 383, 65, 707, 66
0, 7, 166, 66, 137, 70, 114, 90, 96, 157, 98, 494
7, 8, 98, 494, 208, 495, 292, 492
8, 6, 292, 492, 229, 368
6, 3, 229, 368, 164, 224
6, 5, 229, 368, 294, 383, 379, 366
5, 4, 379, 366, 409, 415, 460, 425, 517, 418, 542, 368
4, 5, 542, 368, 457, 348, 379, 366
4, 2, 542, 368, 484, 195
4, 10, 542, 368, 610, 323, 664, 299, 701, 255, 714, 195, 722, 77, 707, 66
10, 11, 707, 66, 756, 70, 778, 85, 785, 148, 745, 366
11, 4, 745, 366, 542, 368
4, 12, 542, 368, 607, 398, 717, 440, 784, 518
12, 9, 784, 518, 689, 555, 638, 555, 540, 521
9, 8, 540, 521, 292, 492
